TILEMAP
144 75							-- Size of tile map in tiles
16 16 							-- Tile size & block size
images/tilesheet.png 					-- Tilesheet
8 8 							-- Number of tiles in tilesheet
0 0 25 26 25 26 25 26 25 26 25 26 25 26 25 26 25 26 25 26 25 26 25 26 25 26 25 26 25 26 25 26 25 26 25 26 25 26 25 26 25 26 25 26 25 26 25 26 25 26 25 26 25 26 25 26 25 26 25 26 25 26 25 0 0 0 0 0 0 0 0 0 0 0 0 0 0 0 0 0 0 0 0 0 0 0 0 0 0 0 0 0 0 0 0 0 0 0 0 0 0 0 0 0 0 0 0 0 0 0 0 0 0 0 0 0 0 0 0 0 0 0 0 0 0 0 0 0 0 0 0 0 0 0 0 0 0 0 0 0 0 0 0 0 
0 0 34 25 34 25 26 25 34 25 34 25 26 25 26 25 26 25 26 25 26 25 26 25 26 25 26 25 26 25 26 25 26 25 26 25 34 25 34 25 34 25 26 25 26 25 34 25 34 25 34 25 26 25 26 25 34 25 34 25 34 25 34 0 0 0 0 0 0 0 0 0 0 0 0 0 0 0 0 0 0 0 0 0 0 0 0 0 0 0 0 0 0 0 0 0 0 0 0 0 0 0 0 0 0 0 0 0 0 0 0 0 0 0 0 0 0 0 0 0 0 0 0 0 0 0 0 0 0 0 0 0 0 0 0 0 0 0 0 0 0 0 0 0 
0 0 41 42 59 60 25 34 25 34 59 60 25 34 25 34 25 34 25 34 25 34 25 34 33 33 25 34 25 34 25 34 25 26 25 34 5 49 50 33 25 34 25 34 25 34 49 50 33 33 25 34 25 34 25 34 41 33 25 34 33 33 42 0 0 0 0 0 0 0 0 0 0 0 0 0 0 0 0 0 0 0 0 0 0 0 0 0 0 0 0 0 0 0 0 0 0 0 0 0 0 0 0 0 0 0 0 0 0 0 0 0 0 0 0 0 0 0 0 0 0 0 0 0 0 0 0 0 0 0 0 0 0 0 0 0 0 0 0 0 0 0 0 0 
0 0 56 56 59 60 42 25 34 33 59 60 33 41 33 25 34 49 50 25 34 25 34 41 49 50 33 25 34 33 5 25 34 25 34 41 13 56 56 42 33 33 42 41 5 41 56 56 42 41 33 41 42 33 33 41 56 42 41 33 41 42 56 0 0 0 0 0 0 0 0 0 0 0 0 0 0 0 0 0 0 0 0 0 0 0 0 0 0 0 0 0 0 0 0 0 0 0 0 0 0 0 0 0 0 0 0 0 0 0 0 0 0 0 0 0 0 0 0 0 0 0 0 0 0 0 0 0 0 0 0 0 0 0 0 0 0 0 0 0 0 0 0 0 
0 0 56 56 59 60 56 42 33 33 59 60 41 56 41 42 42 56 56 41 41 42 42 56 28 56 42 33 42 42 13 41 49 50 42 56 21 22 56 28 41 41 56 56 21 22 56 56 56 56 41 56 56 42 42 56 56 56 56 41 56 56 56 0 0 0 0 0 0 0 0 0 0 0 0 0 0 0 0 0 0 0 0 0 0 0 0 0 0 0 0 0 0 0 0 0 0 0 0 0 0 0 0 0 0 0 0 0 0 0 0 0 0 0 0 0 0 0 0 0 0 0 0 0 0 0 0 0 0 0 0 0 0 0 0 0 0 0 0 0 0 0 0 0 
0 0 56 28 59 60 56 56 42 41 59 60 56 56 56 52 52 52 52 52 56 56 56 56 44 56 56 42 56 56 21 22 56 56 28 56 29 30 56 36 56 56 56 56 29 30 56 56 56 56 56 56 56 56 56 56 56 56 56 56 56 56 56 0 0 0 0 0 0 0 0 0 0 0 0 0 0 0 0 0 0 0 0 0 0 0 0 0 0 0 0 0 0 0 0 0 0 0 0 0 0 0 0 0 0 0 0 0 0 0 0 0 0 0 0 0 0 0 0 0 0 0 0 0 0 0 0 0 0 0 0 0 0 0 0 0 0 0 0 0 0 0 0 0 
0 0 56 36 59 60 56 56 56 56 59 60 28 56 0 0 0 0 0 0 0 56 53 54 6 6 56 56 28 56 29 30 56 56 44 56 56 56 56 44 56 56 56 56 56 56 56 56 56 56 56 56 56 28 56 56 56 56 56 56 56 56 56 0 0 0 0 0 0 0 0 0 0 0 0 0 0 0 0 0 0 0 0 0 0 0 0 0 0 0 0 0 0 0 0 0 0 0 0 0 0 0 0 0 0 0 0 0 0 0 0 0 0 0 0 0 0 0 0 0 0 0 0 0 0 0 0 0 0 0 0 0 0 0 0 0 0 0 0 0 0 0 0 0 
0 0 56 44 59 60 56 28 56 56 59 60 44 56 0 0 0 0 0 0 0 52 61 62 14 14 52 56 44 6 56 56 6 6 53 54 53 54 6 56 53 54 56 6 56 56 0 0 0 0 56 56 56 36 56 56 56 56 28 56 56 56 0 0 0 0 0 0 0 0 0 0 0 0 0 0 0 0 0 0 0 0 0 0 0 0 0 0 0 0 0 0 0 0 0 0 0 0 0 0 0 0 0 0 0 0 0 0 0 0 0 0 0 0 0 0 0 0 0 0 0 0 0 0 0 0 0 0 0 0 0 0 0 0 0 0 0 0 0 0 0 0 0 0 
0 0 56 56 59 60 56 36 56 56 59 60 0 0 0 0 0 0 0 0 0 0 0 0 0 0 0 0 52 14 52 52 14 14 61 62 61 62 14 52 61 62 52 14 52 52 0 0 0 0 52 56 28 36 56 56 56 56 36 56 56 52 0 0 0 0 0 0 0 0 0 0 0 0 0 0 0 0 0 0 0 0 0 0 0 0 0 0 0 0 0 0 0 0 0 0 0 0 0 0 0 0 0 0 0 0 0 0 0 0 0 0 0 0 0 0 0 0 0 0 0 0 0 0 0 0 0 0 0 0 0 0 0 0 0 0 0 0 0 0 0 0 0 0 
0 0 56 56 59 60 56 44 28 56 59 60 56 56 0 0 0 0 0 0 0 0 0 0 0 0 0 0 0 0 0 0 0 0 0 0 0 0 0 0 0 0 0 0 0 0 0 0 0 0 0 0 36 36 56 56 56 56 36 56 0 0 0 0 0 0 0 0 0 0 0 0 0 0 0 0 0 0 0 0 0 0 0 0 0 0 0 0 0 0 0 0 0 0 0 0 0 0 0 0 0 0 0 0 0 0 0 0 0 0 0 0 0 0 0 0 0 0 0 0 0 0 0 0 0 0 0 0 0 0 0 0 0 0 0 0 0 0 0 0 0 0 0 0 
0 0 56 56 59 60 56 56 44 56 59 60 56 56 0 0 0 0 0 0 0 0 0 0 0 0 0 0 0 0 0 0 0 0 0 0 0 0 0 0 0 0 0 0 0 0 0 0 0 0 0 0 44 44 56 56 53 54 44 52 0 0 0 0 0 0 0 0 0 0 0 0 0 0 0 0 0 0 0 0 0 0 0 0 0 0 0 0 0 0 0 0 0 0 0 0 0 0 0 0 0 0 0 0 0 0 0 0 0 0 0 0 0 0 0 0 0 0 0 0 0 0 0 0 0 0 0 0 0 0 0 0 0 0 0 0 0 0 0 0 0 0 0 0 
0 0 0 0 59 60 56 56 0 0 59 60 56 56 0 0 0 0 0 0 0 0 0 0 0 0 0 0 0 0 0 0 0 0 0 0 0 0 0 0 0 0 0 0 0 0 0 0 0 0 0 0 0 0 52 52 61 62 0 0 0 0 0 0 0 0 0 0 0 0 0 0 0 0 0 0 0 0 0 0 0 0 0 0 0 0 0 0 0 0 0 0 0 0 0 0 0 0 0 0 0 0 0 0 0 0 0 0 0 0 0 0 0 0 0 0 0 0 0 0 0 0 0 0 0 0 0 0 0 0 0 0 0 0 0 0 0 0 0 0 0 0 0 0 
0 0 56 56 59 60 28 56 56 56 59 60 56 56 0 0 0 0 0 0 0 0 0 0 0 0 0 0 0 0 0 0 0 0 0 0 0 0 0 0 0 0 0 0 0 0 0 0 0 0 0 0 0 0 0 0 0 0 0 0 0 0 0 0 0 0 0 0 0 0 0 0 0 0 0 0 0 0 0 0 0 0 0 0 0 0 0 0 0 0 0 0 0 0 0 0 0 0 0 0 0 0 0 0 0 0 0 0 0 0 0 0 0 0 0 0 0 0 0 0 0 0 0 0 0 0 0 0 0 0 0 0 0 0 0 0 0 0 0 0 0 0 0 0 
0 0 56 56 59 60 36 56 56 56 59 60 56 56 0 0 0 0 0 0 0 0 0 0 0 0 0 0 0 0 0 0 0 0 0 0 0 0 0 0 0 0 0 0 0 0 0 0 0 0 0 0 0 0 0 0 0 0 0 0 0 0 0 0 0 0 0 0 0 0 0 0 0 0 0 0 0 0 0 0 0 0 0 0 0 0 0 0 0 0 0 0 0 0 0 0 0 0 0 0 0 0 0 0 0 0 0 0 0 0 0 0 0 0 0 0 0 0 0 0 0 0 0 0 0 0 0 0 0 0 0 0 0 0 0 0 0 0 0 0 0 0 0 0 
0 0 56 56 59 60 44 56 56 56 59 60 56 56 0 0 0 0 0 0 0 0 0 0 0 0 0 0 0 0 0 0 0 0 0 0 0 0 0 0 0 0 0 0 0 0 0 0 0 0 0 0 0 0 0 0 0 0 0 0 0 0 0 0 0 0 0 0 0 0 0 0 0 0 0 0 0 0 0 0 0 0 0 0 0 0 0 0 0 0 0 0 0 0 0 0 0 0 0 0 0 0 0 0 0 0 0 0 0 0 0 0 0 0 0 0 0 0 0 0 0 0 0 0 0 0 0 0 0 0 0 0 0 0 0 0 0 0 0 0 0 0 0 0 
0 0 56 56 59 60 56 56 56 56 59 60 56 56 0 0 0 0 0 0 0 0 0 0 0 0 0 0 0 0 0 0 0 0 0 0 0 0 0 0 0 0 0 0 0 0 0 0 0 0 0 0 0 0 0 0 0 0 0 0 0 0 0 0 0 0 0 0 0 0 0 0 0 0 0 0 0 0 0 0 0 0 0 0 0 0 0 0 0 0 0 0 0 0 0 0 0 0 0 0 0 0 0 0 0 0 0 0 0 0 0 0 0 0 0 0 0 0 0 0 0 0 0 0 0 0 0 0 0 0 0 0 0 0 0 0 0 0 0 0 0 0 0 0 
0 0 56 56 59 60 56 56 56 56 59 60 56 56 0 0 0 0 0 0 0 0 0 0 0 0 0 0 0 0 0 0 0 0 0 0 0 0 0 0 0 0 0 0 0 0 0 0 0 0 0 0 0 0 0 0 0 0 0 0 0 0 0 0 0 0 0 0 0 0 0 0 0 0 0 0 0 0 0 0 0 0 0 0 0 0 0 0 0 0 0 0 0 0 0 0 0 0 0 0 0 0 0 0 0 0 0 0 0 0 0 0 0 0 0 0 0 0 0 0 0 0 0 0 0 0 0 0 0 0 0 0 0 0 0 0 0 0 0 0 0 0 0 0 
0 0 56 56 59 60 56 56 56 56 59 60 56 56 0 0 0 0 0 0 0 0 0 0 0 0 0 0 0 0 0 0 0 0 0 0 0 0 0 0 0 0 0 0 0 0 0 0 0 0 0 0 0 0 0 0 0 0 0 0 0 0 0 0 0 0 0 0 0 0 0 0 0 0 0 0 0 0 0 0 0 0 0 0 0 0 0 0 0 0 0 0 0 0 0 0 0 0 0 0 0 0 0 0 0 0 0 0 0 0 0 0 0 0 0 0 0 0 0 0 0 0 0 0 0 0 0 0 0 0 0 0 0 0 0 0 0 0 0 0 0 0 0 0 
0 0 0 0 59 60 56 28 56 56 59 60 0 0 0 0 0 0 0 0 0 0 0 0 0 0 0 0 0 0 0 0 0 0 0 0 0 0 0 0 0 0 0 0 0 0 0 0 0 0 0 0 0 0 0 0 0 0 0 0 0 0 0 0 0 0 0 0 0 0 0 0 0 0 0 0 0 0 0 0 0 0 0 0 0 0 0 0 0 0 0 0 0 0 0 0 0 0 0 0 0 0 0 0 0 0 0 0 0 0 0 0 0 0 0 0 0 0 0 0 0 0 0 0 0 0 0 0 0 0 0 0 0 0 0 0 0 0 0 0 0 0 0 0 
0 0 56 56 59 60 56 36 56 56 59 60 56 56 0 0 0 0 0 0 0 0 0 0 0 0 0 0 0 0 0 0 0 0 0 0 0 0 0 0 0 0 0 0 0 0 0 0 0 0 0 0 0 0 0 0 0 0 0 0 0 0 0 0 0 0 0 0 0 0 0 0 0 0 0 0 0 0 0 0 0 0 0 0 0 0 0 0 0 0 0 0 0 0 0 0 0 0 0 0 0 0 0 0 0 0 0 0 0 0 0 0 0 0 0 0 0 0 0 0 0 0 0 0 0 0 0 0 0 0 0 0 0 0 0 0 0 0 0 0 0 0 0 0 
0 0 56 28 59 60 56 44 56 56 59 60 56 56 0 0 0 0 0 0 0 0 0 0 0 0 0 0 0 0 0 0 0 0 0 0 0 0 0 0 0 0 0 0 0 0 0 0 0 0 0 0 0 0 0 0 0 0 0 0 0 0 0 0 0 0 0 0 0 0 0 0 0 0 0 0 0 0 0 0 0 0 0 0 0 0 0 0 0 0 0 0 0 0 0 0 0 0 0 0 0 0 0 0 0 0 0 0 0 0 0 0 0 0 0 0 0 0 0 0 0 0 0 0 0 0 0 0 0 0 0 0 0 0 0 0 0 0 0 0 0 0 0 0 
0 0 56 44 59 60 56 56 28 56 59 60 0 0 0 0 0 0 0 0 0 0 0 0 0 0 0 0 0 0 0 0 0 0 0 0 0 0 0 0 0 0 0 0 0 0 0 0 0 0 0 0 0 0 0 0 0 0 0 0 0 0 0 0 0 0 0 0 0 0 0 0 0 0 0 0 0 0 0 0 0 0 0 0 0 0 0 0 0 0 0 0 0 0 0 0 0 0 0 0 0 0 0 0 0 0 0 0 0 0 0 0 0 0 0 0 0 0 0 0 0 0 0 0 0 0 0 0 0 0 0 0 0 0 0 0 0 0 0 0 0 0 0 0 
0 0 56 56 59 60 56 56 36 56 59 60 0 0 0 0 0 0 0 0 0 0 0 0 0 0 0 0 0 0 0 0 0 0 0 0 0 0 0 0 0 0 0 0 0 0 0 0 0 0 0 0 0 0 0 0 0 0 0 0 0 0 0 0 0 0 0 0 0 0 0 0 0 0 0 0 0 0 0 0 0 0 0 0 0 0 0 0 0 0 0 0 0 0 0 0 0 0 0 0 0 0 0 0 0 0 0 0 0 0 0 0 0 0 0 0 0 0 0 0 0 0 0 0 0 0 0 0 0 0 0 0 0 0 0 0 0 0 0 0 0 0 0 0 
0 0 56 56 59 60 56 56 44 56 59 60 0 0 0 0 0 0 0 0 0 0 0 0 0 0 0 0 0 0 0 0 0 0 0 0 0 0 0 0 0 0 0 0 0 0 0 0 0 0 0 0 0 0 0 0 0 0 0 0 0 0 0 0 0 0 0 0 0 0 0 0 0 0 0 0 0 0 0 0 0 0 0 0 0 0 0 0 0 0 0 0 0 0 0 0 0 0 0 0 0 0 0 0 0 0 0 0 0 0 0 0 0 0 0 0 0 0 0 0 0 0 0 0 0 0 0 0 0 0 0 0 0 0 0 0 0 0 0 0 0 0 0 0 
0 0 0 0 59 60 56 56 56 56 59 60 56 56 0 0 0 0 0 0 0 0 0 0 0 0 0 0 0 0 0 0 0 0 0 0 0 0 0 0 0 0 0 0 0 0 0 0 0 0 0 0 0 0 0 0 0 0 0 0 0 0 0 0 0 0 0 0 0 0 0 0 0 0 0 0 0 0 0 0 0 0 0 0 0 0 0 0 0 0 0 0 0 0 0 0 0 0 0 0 0 0 0 0 0 0 0 0 0 0 0 0 0 0 0 0 0 0 0 0 0 0 0 0 0 0 0 0 0 0 0 0 0 0 0 0 0 0 0 0 0 0 0 0 
0 0 0 0 59 60 0 0 56 56 59 60 56 28 0 0 0 0 0 0 0 0 0 0 0 0 0 0 0 0 0 0 0 0 0 0 0 0 0 0 0 0 0 0 0 0 0 0 0 0 0 0 0 0 0 0 0 0 0 0 0 0 0 0 0 0 0 0 0 0 0 0 0 0 0 0 0 0 0 0 0 0 0 0 0 0 0 0 0 0 0 0 0 0 0 0 0 0 0 0 0 0 0 0 0 0 0 0 0 0 0 0 0 0 0 0 0 0 0 0 0 0 0 0 0 0 0 0 0 0 0 0 0 0 0 0 0 0 0 0 0 0 0 0 
0 0 56 56 59 60 56 56 56 56 59 60 56 36 0 0 0 0 0 0 0 0 0 0 0 0 0 0 0 0 0 0 0 0 0 0 0 0 0 0 0 0 0 0 0 0 0 0 0 0 0 0 0 0 0 0 0 0 0 0 0 0 0 0 0 0 0 0 0 0 0 0 0 0 0 0 0 0 0 0 0 0 0 0 0 0 0 0 0 0 0 0 0 0 0 0 0 0 0 0 0 0 0 0 0 0 0 0 0 0 0 0 0 0 0 0 0 0 0 0 0 0 0 0 0 0 0 0 0 0 0 0 0 0 0 0 0 0 0 0 0 0 0 0 
0 0 56 56 59 60 56 56 56 56 59 60 56 44 0 0 0 0 0 0 0 0 0 0 0 0 0 0 0 0 0 0 0 0 0 0 0 0 0 0 0 0 0 0 0 0 0 0 0 0 0 0 0 0 0 0 0 0 0 0 0 0 0 0 0 0 0 0 0 0 0 0 0 0 0 0 0 0 0 0 0 0 0 0 0 0 0 0 0 0 0 0 0 0 0 0 0 0 0 0 0 0 0 0 0 0 0 0 0 0 0 0 0 0 0 0 0 0 0 0 0 0 0 0 0 0 0 0 0 0 0 0 0 0 0 0 0 0 0 0 0 0 0 0 
0 0 56 56 59 60 56 56 56 56 59 60 56 56 0 0 0 0 0 0 0 0 0 0 0 0 0 0 0 0 0 0 0 0 0 0 0 0 0 0 0 0 0 0 0 0 0 0 0 0 0 0 0 0 0 0 0 0 0 0 0 0 0 0 0 0 0 0 0 0 0 0 0 0 0 0 0 0 0 0 0 0 0 0 0 0 0 0 0 0 0 0 0 0 0 0 0 0 0 0 0 0 0 0 0 0 0 0 0 0 0 0 0 0 0 0 0 0 0 0 0 0 0 0 0 0 0 0 0 0 0 0 0 0 0 0 0 0 0 0 0 0 0 0 
0 0 56 56 59 60 56 56 56 56 59 60 56 56 0 0 0 0 0 0 0 0 0 0 0 0 0 0 0 0 0 0 0 0 0 0 0 0 0 0 0 0 0 0 0 0 0 0 0 0 0 0 0 0 0 0 0 0 0 0 0 0 0 0 0 0 0 0 0 0 0 0 0 0 0 0 0 0 0 0 0 0 0 0 0 0 0 0 0 0 0 0 0 0 0 0 0 0 0 0 0 0 0 0 0 0 0 0 0 0 0 0 0 0 0 0 0 0 0 0 0 0 0 0 0 0 0 0 0 0 0 0 0 0 0 0 0 0 0 0 0 0 0 0 
0 0 56 56 59 60 56 28 56 56 59 60 56 56 0 0 0 0 0 0 0 0 0 0 0 0 0 0 0 0 0 0 25 26 25 26 25 26 25 26 25 26 25 26 25 26 25 26 25 26 25 26 25 26 25 26 25 26 25 26 25 26 25 26 25 26 25 26 25 26 25 26 25 26 25 26 25 26 25 26 25 26 25 26 25 26 25 26 25 26 25 26 25 26 25 26 25 26 25 26 25 26 25 26 25 26 25 26 25 26 25 26 25 26 25 26 25 26 25 26 25 26 25 26 25 26 25 26 25 26 25 26 25 26 25 26 25 26 25 26 25 26 0 0 
0 0 56 56 59 60 56 36 56 56 59 60 56 56 0 0 0 0 0 0 0 0 0 0 0 0 0 0 0 0 0 0 26 25 26 25 26 25 26 25 26 25 26 25 26 25 26 25 26 25 26 25 26 25 26 25 26 25 26 25 26 25 26 25 26 25 26 25 26 25 26 25 26 25 26 25 26 25 26 25 26 25 26 25 26 25 26 25 26 25 26 25 26 25 26 25 26 25 26 25 26 25 26 25 26 25 26 25 26 25 26 25 26 25 26 25 26 25 34 25 34 25 26 25 34 25 34 25 26 25 26 25 26 25 26 25 26 25 26 25 26 25 0 0 
0 0 56 56 59 60 56 44 56 56 0 0 0 0 0 0 0 0 0 0 0 0 0 0 0 0 0 0 0 0 0 0 25 34 25 26 25 26 25 26 25 34 25 34 25 34 25 34 25 34 25 26 25 26 25 34 25 34 25 34 25 34 25 34 25 34 25 26 25 26 25 26 25 34 25 34 25 34 25 34 25 34 25 34 25 34 25 26 25 26 25 34 25 34 25 34 25 26 25 34 25 34 33 33 41 33 25 34 25 34 25 34 25 34 25 26 25 34 33 33 25 34 25 34 33 33 25 34 25 34 25 34 25 26 25 26 25 26 25 26 25 26 0 0 
0 0 56 56 59 60 56 56 56 56 0 0 0 0 0 0 0 0 0 0 0 0 0 0 0 0 0 0 0 0 0 0 33 25 34 25 34 25 26 25 34 33 33 25 34 49 50 33 33 25 34 25 34 25 34 33 33 25 34 49 50 25 34 33 33 25 34 25 34 25 34 33 33 49 50 25 34 25 34 33 33 25 34 33 33 33 41 25 26 25 34 42 41 41 42 25 34 25 34 33 33 42 33 41 56 41 33 41 41 25 34 33 33 25 34 25 34 33 33 49 50 33 33 33 41 41 42 41 41 42 42 25 34 25 34 25 34 25 34 25 34 25 0 0 
0 0 56 56 59 60 56 56 0 0 0 0 0 0 0 0 0 0 0 0 0 0 0 0 0 0 0 0 0 0 0 0 41 33 41 42 41 25 34 49 50 33 42 41 42 56 56 42 33 41 25 34 33 33 41 42 33 41 41 56 56 42 33 33 41 42 41 49 50 41 33 33 41 56 56 41 33 41 33 41 33 41 41 33 33 41 56 41 33 41 41 56 56 56 56 41 41 33 33 41 42 56 42 56 56 56 41 56 56 41 42 33 42 33 25 34 41 42 42 56 56 41 33 42 56 56 56 56 56 56 56 33 49 50 33 41 25 34 33 33 25 34 0 0 
0 0 56 56 59 60 56 56 56 56 0 0 0 0 0 0 0 0 0 0 0 0 0 0 0 0 0 0 0 0 0 0 56 42 56 56 56 41 42 56 56 42 56 28 56 56 56 56 42 56 33 41 42 33 56 56 42 56 56 56 56 56 33 41 56 56 56 56 56 56 42 33 56 56 56 56 42 56 42 56 41 56 56 42 33 56 56 56 41 56 28 56 37 56 56 56 56 41 42 56 56 56 56 56 0 56 56 56 56 56 56 42 56 42 42 41 56 56 56 56 56 56 42 56 56 56 56 0 0 0 56 42 56 56 41 56 41 41 49 50 41 33 0 0 
0 0 0 0 0 0 56 56 56 56 59 60 56 56 0 0 0 0 0 0 0 0 0 0 0 0 0 0 0 0 0 0 56 56 56 56 56 56 56 56 56 56 56 36 56 56 56 56 56 56 42 56 56 41 56 56 56 56 28 56 56 56 42 56 56 56 56 56 56 56 56 42 56 56 56 56 56 56 56 56 56 56 28 56 42 56 56 56 56 28 36 56 45 0 0 56 56 56 56 56 56 28 56 56 0 56 56 56 56 0 56 56 56 56 56 56 56 56 0 0 56 56 56 56 56 56 56 0 0 0 56 56 56 56 56 56 56 56 56 56 56 41 0 0 
0 0 0 0 0 0 56 56 56 56 59 60 56 56 0 0 0 0 0 0 0 0 0 0 0 0 0 0 0 0 0 0 56 56 56 28 56 56 56 56 56 56 56 44 56 0 0 56 56 56 56 56 56 56 28 56 56 56 44 56 56 56 56 56 56 56 56 56 28 56 56 56 56 56 52 52 56 37 56 56 56 56 36 56 56 56 56 56 56 36 44 0 0 0 0 0 0 56 56 56 56 36 56 0 0 0 56 56 56 0 56 56 56 56 56 56 56 56 0 0 0 56 56 56 56 56 0 0 0 0 56 56 56 56 56 56 56 28 56 56 56 56 0 0 
0 0 0 0 0 0 56 56 56 56 59 60 56 56 0 0 0 0 0 0 0 0 0 0 0 0 0 0 0 0 0 0 56 56 56 36 56 56 56 56 28 56 37 56 52 0 0 56 37 56 56 28 56 56 44 56 0 0 0 0 52 56 56 56 28 56 56 56 36 28 56 56 56 0 0 0 0 45 56 37 37 56 44 56 56 56 56 56 37 44 0 0 0 0 0 0 0 0 56 56 56 44 56 0 0 0 38 56 56 0 0 56 56 56 56 56 56 0 0 0 0 56 56 56 56 56 0 0 0 0 0 56 56 56 56 28 56 36 56 56 56 56 0 0 
0 0 0 0 0 0 0 0 56 56 59 60 56 56 0 0 0 0 0 0 0 0 0 0 0 0 0 0 0 0 0 0 0 56 56 44 56 56 28 56 44 37 45 0 0 0 0 52 45 52 56 44 56 56 0 0 0 0 0 0 0 0 56 56 36 56 56 56 36 36 56 56 52 0 0 0 0 0 0 45 45 56 56 56 56 56 37 56 45 0 0 0 0 0 0 0 0 0 56 56 56 56 0 0 0 0 46 56 56 0 0 56 56 56 56 56 56 0 0 0 0 0 56 56 38 56 0 0 0 0 0 56 56 56 56 36 56 44 56 56 28 56 0 0 
0 0 56 56 59 60 56 56 56 56 59 60 56 56 0 0 0 0 0 0 0 0 0 0 0 0 0 0 0 0 0 0 0 52 56 53 54 56 44 56 0 0 0 0 0 0 0 0 0 0 0 52 52 52 0 0 0 0 0 0 0 0 52 52 44 53 54 56 44 44 52 0 0 0 0 0 0 0 0 0 0 0 56 38 56 56 45 0 0 0 0 0 0 0 0 0 0 0 0 38 56 56 0 0 0 0 0 52 52 0 0 52 56 38 56 56 0 0 0 0 0 0 0 52 46 0 0 0 0 0 0 52 56 56 56 44 56 56 56 56 36 56 0 0 
0 0 56 56 59 60 56 56 56 56 59 60 56 56 0 0 0 0 0 0 0 0 0 0 0 0 0 0 0 0 0 0 0 0 0 61 62 52 52 0 0 0 0 0 0 0 0 0 0 0 0 0 0 0 0 0 0 0 0 0 0 0 0 0 0 61 62 52 52 0 0 0 0 0 0 0 0 0 0 0 0 0 37 46 37 0 0 0 0 0 0 0 0 0 0 0 0 0 0 46 52 0 0 0 0 0 0 0 0 0 0 0 0 46 52 0 0 0 0 0 0 0 0 0 0 0 0 0 0 0 0 0 0 56 56 56 56 56 56 56 44 56 0 0 
0 0 56 56 59 60 56 56 56 28 59 60 0 0 0 0 0 0 0 0 0 0 0 0 0 0 0 0 0 0 0 0 0 0 0 0 0 0 0 0 0 0 0 0 0 0 0 0 0 0 0 0 0 0 0 0 0 0 0 0 0 0 0 0 0 0 0 0 0 0 0 0 0 0 0 0 0 0 0 0 0 0 0 0 0 0 0 0 0 0 0 0 0 0 0 0 0 0 0 0 0 0 0 0 0 0 0 0 0 0 0 0 0 0 0 0 0 0 0 0 0 0 0 0 0 0 0 0 0 0 0 0 0 52 52 56 56 56 56 56 56 56 0 0 
0 0 56 56 59 60 0 0 56 36 59 60 56 56 0 0 0 0 0 0 0 0 0 0 0 0 0 0 0 0 0 0 0 0 0 0 0 0 0 0 0 0 0 0 0 0 0 0 0 0 0 0 0 0 0 0 0 0 0 0 0 0 0 0 0 0 0 0 0 0 0 0 0 0 0 0 0 0 0 0 0 0 0 0 0 0 0 0 0 0 0 0 0 0 0 0 0 0 0 0 0 0 0 0 0 0 0 0 0 0 0 0 0 0 0 0 0 0 0 0 0 0 0 0 0 0 0 0 0 0 0 0 0 0 0 0 52 56 56 56 56 56 0 0 
0 0 56 56 59 60 56 56 56 44 59 60 56 56 0 0 0 0 0 0 0 0 0 0 0 0 0 0 0 0 0 0 0 0 0 0 0 0 0 0 0 0 0 0 0 0 0 0 0 0 0 0 0 0 0 0 0 0 0 0 0 0 0 0 0 0 0 0 0 0 0 0 0 0 0 0 0 0 0 0 0 0 0 0 0 0 0 0 0 0 0 0 0 0 0 0 0 0 0 0 0 0 0 0 0 0 0 0 0 0 0 0 0 0 0 0 0 0 0 0 0 0 0 0 0 0 0 0 0 0 0 0 0 0 0 0 0 0 56 56 56 56 0 0 
0 0 56 56 59 60 56 56 0 0 59 60 56 28 0 0 0 0 0 0 0 0 0 0 0 0 0 0 0 0 0 0 0 0 0 0 0 0 0 0 0 0 0 0 0 0 0 0 0 0 0 0 0 0 0 0 0 0 0 0 0 0 0 0 0 0 0 0 0 0 0 0 0 0 0 0 0 0 0 0 0 0 0 0 0 0 0 0 0 0 0 0 0 0 0 0 0 0 0 0 0 0 0 0 0 0 0 0 0 0 0 0 0 0 0 0 0 0 0 0 0 0 0 0 0 0 0 0 0 0 0 0 0 0 0 0 0 0 56 56 56 56 0 0 
0 0 0 0 59 60 56 56 56 56 59 60 56 36 0 0 0 0 0 0 0 0 0 0 0 0 0 0 0 0 0 0 0 0 0 0 0 0 0 0 0 0 0 0 0 0 0 0 0 0 0 0 0 0 0 0 0 0 0 0 0 0 0 0 0 0 0 0 0 0 0 0 0 0 0 0 0 0 0 0 0 0 0 0 0 0 0 0 0 0 0 0 0 0 0 0 0 0 0 0 0 0 0 0 0 0 0 0 0 0 0 0 0 0 0 0 0 0 0 0 0 0 0 0 0 0 0 0 0 0 0 0 0 0 0 33 42 56 56 56 56 56 0 0 
0 0 56 56 59 60 56 56 56 56 59 60 56 44 0 0 0 0 0 0 0 0 0 0 0 0 0 0 0 0 0 0 0 0 0 0 0 0 0 0 0 0 0 0 0 0 0 0 0 0 0 0 0 0 0 0 0 0 0 0 0 0 0 0 0 0 0 0 0 0 0 0 0 0 0 0 0 0 0 0 0 0 0 0 0 0 0 0 0 0 0 0 0 0 0 0 0 0 0 0 0 0 0 0 0 0 0 0 0 0 0 0 0 0 0 0 0 0 0 0 0 0 0 0 0 0 0 0 0 0 0 0 33 33 41 42 56 56 56 56 56 37 0 0 
0 0 56 56 59 60 56 56 56 56 59 60 56 56 0 0 0 0 0 0 0 0 0 0 0 0 0 0 0 0 0 0 0 0 0 0 0 0 0 0 0 0 0 0 0 0 0 0 0 0 0 0 0 0 0 0 0 0 0 0 0 0 0 0 0 0 0 0 0 0 0 0 0 0 0 0 0 0 0 0 0 0 0 0 0 0 0 0 0 0 0 0 0 0 0 0 0 0 0 0 0 0 0 0 0 0 0 0 0 0 0 0 0 0 0 0 0 0 0 0 0 0 0 0 0 0 0 0 0 0 0 33 33 41 56 56 56 56 37 37 56 45 0 0 
0 0 0 0 59 60 56 56 28 56 59 60 0 0 0 0 0 0 0 0 0 0 0 0 0 0 0 0 0 0 0 0 0 0 0 0 0 0 0 0 0 0 0 0 0 0 0 0 0 0 0 0 0 0 0 0 0 0 0 0 0 0 0 0 0 0 0 0 0 0 0 0 0 0 0 0 0 0 0 0 0 0 0 0 0 0 0 0 0 0 0 0 0 0 0 0 0 0 0 0 0 0 0 0 0 0 0 0 0 0 0 0 0 0 0 0 0 0 0 0 0 0 0 0 0 0 0 0 0 0 0 42 41 56 56 56 37 56 45 45 0 0 0 0 
0 0 0 0 59 60 56 56 36 56 59 60 56 56 0 0 0 0 0 0 0 0 0 0 0 0 0 0 0 0 0 0 0 0 0 0 0 0 0 0 0 0 0 0 0 0 0 0 0 0 0 0 0 0 0 0 0 0 0 0 0 0 0 0 0 0 0 0 0 0 0 0 0 0 0 0 0 0 0 0 0 0 0 0 0 0 0 0 0 0 0 0 0 0 0 0 0 0 0 0 0 0 0 0 0 0 0 0 0 0 0 0 0 0 0 0 0 0 0 0 0 0 0 0 0 0 0 0 0 0 0 56 56 56 37 56 45 0 0 0 0 0 0 0 
0 0 0 0 59 60 56 56 44 56 59 60 56 56 0 0 0 0 0 0 0 0 0 0 0 0 0 0 0 0 0 0 0 0 0 0 0 0 0 0 0 0 0 0 0 0 0 0 0 0 0 0 0 0 0 0 0 0 0 0 0 0 0 0 0 0 0 0 0 0 0 0 0 0 0 0 0 0 0 0 0 0 0 0 0 0 0 0 0 0 0 0 0 0 0 0 0 0 0 0 0 0 0 0 0 0 0 0 0 0 0 0 0 0 0 0 0 0 0 0 0 0 0 0 0 0 0 0 0 41 56 56 56 56 45 0 0 0 0 0 0 0 0 0 
0 0 56 56 59 60 56 56 56 56 59 60 56 56 0 0 0 0 0 0 0 0 0 0 0 0 0 0 0 0 0 0 0 0 0 0 0 0 0 0 0 0 0 0 0 0 0 0 0 0 0 0 0 0 0 0 0 0 0 0 0 0 0 0 0 0 0 0 0 0 0 0 0 0 0 0 0 0 0 0 0 0 0 0 0 0 0 0 0 0 0 0 0 0 0 0 0 0 0 0 0 0 0 0 0 0 0 0 0 0 0 0 0 0 0 0 0 0 0 0 0 0 0 0 0 0 0 0 0 56 56 56 56 0 0 0 0 0 0 0 0 0 0 0 
0 0 56 56 59 60 0 0 56 56 59 60 0 0 0 0 0 0 0 0 0 0 0 0 0 0 0 0 0 0 0 0 0 0 0 0 0 0 0 0 0 0 0 0 0 0 0 0 0 0 0 0 0 0 0 0 0 0 0 0 0 0 0 0 0 0 0 0 0 0 0 0 0 0 0 0 0 0 0 0 0 0 0 0 0 0 0 0 0 0 0 0 0 0 0 0 0 0 0 0 0 0 0 0 0 0 0 0 0 0 0 0 0 0 0 0 0 0 0 0 0 0 0 0 0 0 0 0 0 37 56 56 56 56 41 0 0 0 0 0 0 0 0 0 
0 0 56 56 59 60 56 28 56 56 59 60 56 56 0 0 0 0 0 0 0 0 0 0 0 0 0 0 0 0 0 0 0 0 0 0 0 0 0 0 0 0 0 0 0 0 0 0 0 0 0 0 0 0 0 0 0 0 0 0 0 0 0 0 0 0 0 0 0 0 0 0 0 0 0 0 0 0 0 0 0 0 0 0 0 0 0 0 0 0 0 0 0 0 0 0 0 0 0 0 0 0 0 0 0 0 0 0 0 0 0 0 0 0 0 0 0 0 0 0 0 0 0 0 0 0 0 0 0 45 56 56 56 28 56 0 0 0 0 0 0 0 0 0 
0 0 56 28 59 60 56 36 56 56 59 60 56 56 0 0 0 0 0 0 0 0 0 0 0 0 0 0 0 0 0 0 0 0 0 0 0 0 0 0 0 0 0 0 0 0 0 0 0 0 0 0 0 0 0 0 0 0 0 0 0 0 0 0 0 0 0 0 0 0 0 0 0 0 0 0 0 0 0 0 0 0 0 0 0 0 0 0 0 0 0 0 0 0 0 0 0 0 0 0 0 0 0 0 0 0 0 0 0 0 0 0 0 0 0 0 0 0 0 0 0 0 0 0 0 0 0 0 0 0 0 37 56 36 28 56 42 33 0 0 0 0 0 0 
0 0 56 36 59 60 56 44 56 56 59 60 56 56 0 0 0 0 0 0 0 0 0 0 0 0 0 0 0 0 0 0 0 0 0 0 0 0 0 0 0 0 0 0 0 0 0 0 0 0 0 0 0 0 0 0 0 0 0 0 0 0 0 0 0 0 0 0 0 0 0 0 0 0 0 0 0 0 0 0 0 0 0 0 0 0 0 0 0 0 0 0 0 0 0 0 0 0 0 0 0 0 0 0 0 0 0 0 0 0 0 0 0 0 0 0 0 0 0 0 0 0 0 0 0 0 0 0 0 0 0 45 56 44 36 56 56 41 33 33 0 0 0 0 
0 0 56 44 59 60 0 0 56 56 59 60 0 0 0 0 0 0 0 0 0 0 0 0 0 0 0 0 0 0 0 0 0 0 0 0 0 0 0 0 0 0 0 0 0 0 0 0 0 0 0 0 0 0 0 0 0 0 0 0 0 0 0 0 0 0 0 0 0 0 0 0 0 0 0 0 0 0 0 0 0 0 0 0 0 0 0 0 0 0 0 0 0 0 0 0 0 0 0 0 0 0 0 0 0 0 0 0 0 0 0 0 0 0 0 0 0 0 0 0 0 0 0 0 0 0 0 0 0 0 0 0 0 56 44 56 56 56 42 41 0 0 0 0 
0 0 0 0 59 60 56 56 56 28 59 60 0 0 0 0 0 0 0 0 0 0 0 0 0 0 0 0 0 0 0 0 0 0 0 0 0 0 0 0 0 0 0 0 0 0 0 0 0 0 0 0 0 0 0 0 0 0 0 0 0 0 0 0 0 0 0 0 0 0 0 0 0 0 0 0 0 0 0 0 0 0 0 0 0 0 0 0 0 0 0 0 0 0 0 0 0 0 0 0 0 0 0 0 0 0 0 0 0 0 0 0 0 0 0 0 0 0 0 0 0 0 0 0 0 0 0 0 0 0 0 0 0 37 37 37 37 56 56 56 56 42 33 0 
0 0 56 56 59 60 56 56 56 44 59 60 0 0 0 0 0 0 0 0 0 0 0 0 0 0 0 0 0 0 0 0 0 0 0 0 0 0 0 0 0 0 0 0 0 0 0 0 0 0 0 0 0 0 0 0 0 0 0 0 0 0 0 0 0 0 0 0 0 0 0 0 0 0 0 0 0 0 0 0 0 0 0 0 0 0 0 0 0 0 0 0 0 0 0 0 0 0 0 0 0 0 0 0 0 0 0 0 0 0 0 0 0 0 0 0 0 0 0 0 0 0 0 0 0 0 0 0 0 0 0 0 0 45 45 45 45 56 37 56 56 56 41 0 
0 0 56 56 59 60 56 56 56 56 59 60 56 56 0 0 25 26 25 26 25 26 25 26 25 26 25 26 25 26 25 26 25 26 25 26 25 26 25 26 25 26 25 26 25 26 25 26 25 26 25 26 25 26 25 26 25 26 25 26 25 26 25 26 25 26 25 26 25 26 59 60 25 26 25 59 60 26 25 26 59 60 25 26 25 26 59 60 25 26 59 60 25 26 25 26 25 59 60 26 25 26 59 60 25 26 59 60 25 26 25 26 25 26 59 60 25 26 25 26 25 26 25 26 25 0 0 0 0 0 0 0 0 0 0 0 0 0 45 56 56 56 56 0 
0 0 56 56 59 60 56 56 56 56 59 60 56 56 0 0 26 25 26 25 26 25 26 25 26 25 26 25 26 25 26 25 26 25 26 25 26 25 26 25 26 25 26 25 26 25 26 25 26 25 26 25 26 25 26 25 26 25 26 25 26 25 26 25 26 25 26 25 26 25 59 60 26 25 26 59 60 25 34 25 59 60 26 25 26 25 59 60 26 25 59 60 26 25 26 25 26 59 60 25 26 25 59 60 26 25 59 60 26 25 34 25 34 25 59 60 26 25 26 25 26 25 26 25 26 0 0 0 0 0 0 0 0 0 0 0 0 0 0 0 56 56 56 0 
0 0 0 0 59 60 56 56 0 0 59 60 56 56 0 0 25 34 25 34 25 26 25 26 25 26 25 34 25 34 25 34 25 34 25 26 25 26 25 26 25 34 25 34 25 34 25 34 25 34 25 34 25 34 25 34 25 34 25 26 25 34 25 34 25 34 25 34 25 34 59 60 25 34 25 59 60 33 25 34 59 60 25 34 25 34 59 60 25 26 59 60 25 34 25 34 25 59 60 34 25 34 59 60 25 26 59 60 25 34 33 33 25 34 59 60 25 34 25 34 25 34 25 34 25 0 0 0 0 0 0 0 0 0 0 0 0 0 0 0 56 56 56 0 
0 0 56 56 59 60 56 56 56 56 59 60 56 28 56 56 33 41 33 25 34 25 26 25 34 25 34 33 33 25 34 33 33 25 34 25 34 25 34 25 34 49 50 25 34 42 33 41 33 33 33 25 34 33 49 50 33 25 34 25 34 33 33 41 33 42 33 25 34 42 59 60 41 25 34 59 60 49 50 33 59 60 33 25 34 33 59 60 41 25 59 60 41 41 49 50 41 59 60 49 50 33 59 60 41 42 59 60 42 33 41 33 42 42 59 60 41 25 34 33 33 25 34 42 41 0 0 0 0 0 0 0 0 0 0 0 33 33 41 56 56 56 56 0 
0 0 56 56 59 60 28 56 56 56 59 60 56 44 56 56 42 56 41 42 25 34 25 34 41 42 41 33 42 33 41 42 33 41 33 41 25 34 49 50 41 56 56 41 42 56 42 56 41 41 33 41 33 41 56 56 41 41 33 33 33 41 42 56 41 56 41 42 42 56 59 60 56 41 42 59 60 56 56 41 59 60 42 41 33 42 59 60 56 42 59 60 0 0 56 56 56 59 60 56 56 41 59 60 56 56 59 60 56 42 56 41 0 0 59 60 56 42 41 33 42 41 56 56 56 0 0 0 0 0 0 0 0 0 0 0 33 42 56 56 56 6 6 0 
0 0 28 56 59 60 36 56 56 56 59 60 0 0 28 56 56 56 56 56 42 33 41 41 56 56 56 41 56 42 56 56 42 56 42 56 41 41 56 56 56 56 56 56 56 56 56 56 56 56 42 56 42 56 56 56 56 56 41 42 42 56 56 56 56 56 56 56 56 56 59 60 0 0 56 59 60 56 56 56 59 60 56 56 42 56 59 60 56 56 59 60 56 56 56 56 56 59 60 56 56 56 59 60 0 0 59 60 56 56 56 56 56 56 59 60 56 56 56 42 56 56 56 56 56 56 0 0 0 0 0 0 0 0 33 33 41 56 56 6 56 14 14 0 
0 0 44 56 59 60 44 56 0 0 59 60 56 56 36 56 56 56 56 56 56 42 56 56 56 56 56 56 56 56 56 56 3 4 56 56 56 56 56 3 4 56 56 56 56 56 56 3 4 56 56 56 56 56 56 56 56 56 56 56 56 56 56 56 56 56 56 56 56 56 59 60 56 56 56 59 60 0 0 56 59 60 56 56 0 0 59 60 56 56 59 60 56 56 56 56 56 59 60 56 56 56 59 60 56 56 59 60 56 56 56 56 56 56 59 60 56 56 56 56 56 56 56 56 56 56 56 0 0 0 0 0 0 0 41 42 28 56 56 14 0 0 0 0 
0 0 6 6 59 60 56 6 56 56 59 60 56 6 44 6 6 6 56 6 56 56 56 56 56 56 56 56 56 56 56 56 11 12 56 56 56 56 56 11 12 56 56 56 3 4 56 11 12 56 56 56 56 56 56 56 56 56 56 56 56 56 56 56 56 56 56 56 56 56 59 60 56 56 56 59 60 56 56 56 59 60 56 56 56 56 59 60 56 56 59 60 56 56 56 56 56 59 60 56 56 56 59 60 56 56 59 60 56 56 56 56 56 56 59 60 56 56 56 56 56 56 56 56 56 56 56 0 0 0 0 0 0 0 56 56 36 56 0 0 0 0 0 0 
0 0 14 14 59 60 52 14 52 52 59 60 52 14 52 14 14 14 56 14 56 56 53 54 53 54 56 56 56 56 56 56 19 20 56 56 3 4 56 19 20 3 4 56 11 12 56 19 20 56 56 0 0 0 0 0 0 0 0 56 56 56 56 56 56 56 56 56 56 56 59 60 56 56 56 59 60 56 56 56 59 60 56 56 56 56 59 60 56 56 59 60 56 56 56 0 0 59 60 0 0 56 59 60 56 56 59 60 56 56 56 56 56 56 59 60 56 56 56 56 56 0 0 56 56 56 56 56 56 56 56 56 56 56 28 56 44 6 0 0 0 0 0 0 
0 0 0 0 0 0 0 0 0 0 0 0 0 0 0 0 0 0 0 0 0 0 61 62 61 62 52 52 52 52 56 56 19 20 56 56 11 12 56 19 20 11 12 56 19 20 56 19 20 56 56 0 0 0 0 0 0 0 0 56 56 56 56 56 56 56 56 56 56 56 59 60 56 56 56 59 60 56 56 56 59 60 56 56 56 56 59 60 56 56 59 60 56 56 56 56 56 59 60 56 56 56 59 60 56 56 59 60 0 0 56 56 56 56 59 60 0 0 56 56 56 0 0 56 56 56 56 56 56 56 56 56 56 56 36 56 56 14 0 0 0 0 0 0 
0 0 0 0 0 0 0 0 0 0 0 0 0 0 0 0 0 0 0 0 0 0 0 0 0 0 0 0 0 0 0 56 19 20 6 56 19 20 6 19 20 19 20 6 0 0 0 0 0 0 0 0 0 0 0 0 0 0 0 0 0 0 0 0 56 56 56 56 0 0 59 60 56 56 56 59 60 56 56 56 59 60 56 56 56 56 59 60 0 0 59 60 56 56 56 56 56 59 60 56 56 56 59 60 56 56 59 60 56 56 56 56 56 56 59 60 56 56 56 56 56 0 0 0 56 56 6 6 6 6 6 6 53 54 44 56 0 0 0 0 0 0 0 0 
0 0 0 0 0 0 0 0 0 0 0 0 0 0 0 0 0 0 0 0 0 0 0 0 0 0 0 0 0 0 0 56 19 20 14 56 19 20 14 19 20 19 20 14 0 0 0 0 0 0 0 0 0 0 0 0 0 0 0 0 0 0 0 0 35 27 56 18 56 35 59 60 56 27 35 59 60 35 27 18 59 60 35 56 27 35 59 60 27 56 59 60 18 35 27 56 35 59 60 27 35 56 59 60 35 56 59 60 27 35 27 35 18 56 59 60 18 35 35 27 35 0 0 0 0 52 14 14 14 14 14 14 61 62 52 52 0 0 0 0 0 0 0 0 
0 0 0 0 0 0 0 0 0 0 0 0 0 0 0 0 0 0 0 0 0 0 0 0 0 0 0 0 0 0 0 0 0 0 0 0 0 0 0 0 0 0 0 0 0 0 0 0 0 0 0 0 0 0 0 0 0 0 0 0 0 0 0 0 0 0 0 0 0 0 0 0 0 0 0 0 0 0 0 0 0 0 0 0 0 0 0 0 0 0 0 0 0 0 0 0 0 0 0 0 0 0 0 0 0 0 0 0 0 0 0 0 0 0 0 0 0 0 0 0 0 0 0 0 0 0 0 0 0 0 0 0 0 0 0 0 0 0 0 0 0 0 0 0 
0 0 0 0 0 0 0 0 0 0 0 0 0 0 0 0 0 0 0 0 0 0 0 0 0 0 0 0 0 0 0 0 0 0 0 0 0 0 0 0 0 0 0 0 0 0 0 0 0 0 0 0 0 0 0 0 0 0 0 0 0 0 0 0 0 0 0 0 0 0 0 0 0 0 0 0 0 0 0 0 0 0 0 0 0 0 0 0 0 0 0 0 0 0 0 0 0 0 0 0 0 0 0 0 0 0 0 0 0 0 0 0 0 0 0 0 0 0 0 0 0 0 0 0 0 0 0 0 0 0 0 0 0 0 0 0 0 0 0 0 0 0 0 0 
0 0 0 0 0 0 0 0 0 0 0 0 0 0 0 0 0 0 0 0 0 0 0 0 0 0 0 0 0 0 0 0 0 0 0 0 0 0 0 0 0 0 0 0 0 0 0 0 0 0 0 0 0 0 0 0 0 0 0 0 0 0 0 0 0 0 0 0 0 0 0 0 0 0 0 0 0 0 0 0 0 0 0 0 0 0 0 0 0 0 0 0 0 0 0 0 0 0 0 0 0 0 0 0 0 0 0 0 0 0 0 0 0 0 0 0 0 0 0 0 0 0 0 0 0 0 0 0 0 0 0 0 0 0 0 0 0 0 0 0 0 0 0 0